__________
xx___#____
_x___#____
_x___#____
_#___#____
_#________
__________
__________
_x###_#x__
__________