______________#
_x____________#
_x___m_________
_x_x_x_x_x_x_x#
______________#