______________#
_x____________#
_x____________#
_x_x_x_x_x_x_x#
______________#