______________#
_x____________#
_x___m________#
_x_x_x_x_x_x_x#
______________#