______________#
_x____________#
_x___m__P______
_x_x_x_x_x_x_x#
______________#