_____________________
____h________________
_________#______x____
________h____________
____x___h____xF______
______________Q______
_____S___x____E______
________________i____
____x_______P________
_____ww_________x____
____w____xx__________
____w____xx__________
