_____________________
_____________________
_________#______x____
_____________________
____x________xF______
______________E______
_________x____E______
_____________________
____x_______P________
________________x____
_________xx__________
_________xx__________
